33
33
150
150
---------------------------------
-0110101010000000001101110110110-
-0110111101010000000100011011011-
-0010110000100100000000000111000-
-0011000110100010011111100110100-
-0101110100100011001001100000110-
-1001100011111100001111001111011-
-1100010010010101111010010100010-
-1011000111000011000010111110100-
-0001111100100010100101101111110-
-1011011011100110000000000110000-
-0100111110001010010100101100100-
-0110011010001101110011110011011-
-0010111110010101000110001100111-
-0100100011001010011101001101100-
-1101111111100101010111101101010-
-0000011001111010111011001101001-
-1010011100110110011110010011000-
-1110101100010110011110101110001-
-0110010001101110111100111010101-
-0111011111010101100110110110000-
-1100111011001001001111110100000-
-1001011001010001100111110001001-
-0111101001011010111001100100111-
-0010000001011010010110010011000-
-0010001101011011010100110010001-
-0010000101010111011000000011000-
-0110110001100101100010001101011-
-0010010010100010011110111010010-
-1010010011100111011001101010101-
-1111101110100001100111001110101-
-0101010111001000011101001010101-
---------------------------------
---------------------------------
-0000000000000000000000000000000-
-0000000000000000m00000000000000-
-0000000000000000000000000000000-
-0000000000000000000000000000000-
-00000000000000000000000000m0000-
-0000000000000000000000000000000-
-0000000000000000000000000000000-
-0000m00000000000000000000000000-
-0000000000000000000000000000000-
-000000000m0m0m0m0m0m0m000000000-
-0000000000000000000000000000000-
-000000000m00000000000m0000000m0-
-0000000000000000000000000000000-
-000m00000m00000000000m000000000-
-0000000000000000000000000000000-
-000000000m00000m00000m000000000-
-000m000000000000000000000000000-
-000000000m00000000000m000m00000-
-000000m000000000000000000000000-
-000000000m00000000000m0000m0000-
-0000000000000000000000000000000-
-000000000m0m0m0m0m0m0m000000000-
-000m0000000000000000000000m0000-
-00000000000000000000m0000000000-
-000000000m000000000000000000000-
-00000000m00000000m0000000000000-
-0000000000000000000000000000000-
-0000000000000000000000000000000-
-000000000000000000000000000k000-
-0000000000000000000000000000000-
-0000000000000000000000000000000-
---------------------------------