33
33
150
150
---------------------------------
-0110101010000000001101110110110-
-0110111101010000000100011011011-
-0010110000100100000000000111000-
-0011000110100010011111100110100-
-0101110100100011001001100000110-
-1001100011111100001111001111011-
-1100010010010101111010010100010-
-1011000111000011000010111110100-
-0001111100100010100101101111110-
-101101101-------------000110000-
-010011111-00101001010-101100100-
-011001101-00110111001-110011011-
-001011111-01010100011-001100111-
-010010001-00101001110-001101100-
-110111111-10010101011-101101010-
-000001100-11101011101-001101001-
-101001110-11011001111-010011000-
-111010110-01011001111-101110001-
-011001000-10111011110-111010101-
-011101111-01010110011-110110000-
-110011101-00100100111-110100000-
-100101100-------------110001001-
-0111101001011010111001100100111-
-0010000001011010010110010011000-
-0010001101011011010100110010001-
-0010000101010111011000000011000-
-0110110001100101100010001101011-
-0010010010100010011110111010010-
-1010010011100111011001101010101-
-1111101110100001100111001110101-
-0101010111001000011101001010101-
---------------------------------
---------------------------------
-0000000000000000000000000000000-
-0000000000000000000000000000000-
-0000000000000000000000000000000-
-0000000000000000000000000000000-
-00000000000000000000000000m0000-
-0000000000000000000000000000000-
-0000000000000000000000000000000-
-0000000000000000000000000000000-
-0000000000000000000000000000000-
-000000000-------------000000000-
-000000000-00000000000-000000000-
-000000000-00000000000-000000000-
-000000000-00000000000-000000000-
-000000000-00000000000-000000000-
-000000000-00000000000-000000000-
-000000000-00000k00000-000000000-
-000000000-00000000000-000000000-
-000000000-00000000000-000000000-
-000000000-00000000000-000000000-
-000000000-00000000000-000000000-
-000000000-00000000000-000000000-
-000000000-------------000000000-
-0000000000000000000000000000000-
-0000000000000000000000000000000-
-0000000000000000000000000000000-
-0000000000000000000000000000000-
-0000000000000000000000000000000-
-0000000000000000000000000000000-
-0000000000000000000000000000000-
-0000000000000000000000000000000-
-0000000000000000000000000000000-
---------------------------------