23
33
150
150
-----------------------
-0101100001-1001110111-
-0011001111-0101000011-
-0010101011-1010011110-
-1100011001-1001010101-
-0011100100-0011000011-
-0110010001-0101011110-
------------0111010110-
-010110111111100111111-
-010111111110010110001-
-000011100000000001110-
-100010101001011110011-
-100111100111111111000-
-011010101111000001110-
-100100110111101100001-
-011110100110011001101-
-111110000111100110100-
-000101011001101000000-
-101001110110010000011-
-110110010010101110111-
-011110101110010110101-
-100001001101010110000-
-000111011000100011101-
-111001010001110001001-
-000110001000111110100-
-111011110000110010111-
-110011110101100001110-
-000010011100100100010-
-100011111110001011100-
-110011010110101011101-
-001000010110001000111-
-100110001011110001101-
-----------------------
-----------------------
-0000000000-0000a0000a-
-0000000000-0000s0000s-
-0000000000-0000s0000s-
-0000000000-0000s0000s-
-0000000000-0000s0000s-
-0000000000-0000s0000s-
------------0000s0000s-
-000000000000000s0000s-
-000000000000000s0000s-
-000000000000000s0000s-
-00m000000000000s0000s-
-000000000000000s0000s-
-000000000000000d0000d-
-qwwwwwwwwwwwwwe0qwwe0-
-000000000000000a0000a-
-000000000000000s0000s-
-0000000000000m0s0000s-
-000000000000000s0000s-
-000000000000000s0000s-
-000000000000000d0000d-
-qwwwwwwwwwwwwwe0qwwe0-
-000000000000000a0000a-
-000000000000000s0000s-
-000000000000000s0000s-
-000000000000000s0000s-
-0m0000000000000s0000s-
-000000000000000s0000s-
-000000000000000s0000s-
-000000000000000s0000s-
-000000000000000s0000s-
-000000000000000d00k0d-
-----------------------