27
27
540
100
---------------------------
-1010001000011100001101101-
-0001010010011110000111111-
-1000101011011101010111011-
-1011111001010111101101001-
-1110010000101110111000011-
-1100110111111101100000000-
-1100101011111011010000100-
-0000011111111110001110000-
-1011111001111000101011011-
-0110010110010111010011010-
-1111111001001010110110110-
-1001101000100111000011000-
-0100010111001100001010001-
-0010100101101000100000010-
-0011010101110011111010111-
-1010100001101000110011100-
-0100110001000101101001000-
-0001001010000111011011101-
-0001000010001111100001010-
-0101001100110101011011011-
-0001110101100001011101111-
-0110010110001000111001011-
-1110111111000111111000110-
-1010101100000111001011101-
-0100110000001110010101000-
---------------------------
---------------------------
-0qwwwwwwe0qwwe00000000000-
-a00000000a0000a00m0000000-
-sk0000000s0000s000000m000-
-s00000000s0000s000m000000-
-s00000000s0000s000000m000-
-d00000000d0000d00m0000000-
-0qwwwwwwe000000qwwwwwwwwe-
-a00000000a0000a0000aaaaaa-
-s00000000d0000d0000ssssss-
-s000000000qwwe00000ssssss-
-s00000000a0000a0000ssssss-
-d00000000d00m0s0000dddddd-
-0qwwwwwwe00000s000000000s-
-a00000000a0m00s0000000m0s-
-s00000000s000ms000000000s-
-sm0000000s0m00s000000000s-
-s00000000d0000d000000000d-
-d00000000qwwwwwwwwwwwwwe0-
-0qwwwwwwe000000000000000a-
-a00000000a00000000000000s-
-s00000000s00000000000000s-
-s00000000s00000000000000s-
-s00000000s00000000000000s-
-d00000000d00000000000000d-
-0qwwwwwwwwwwwwwwwwwwwwwe0-
---------------------------